# name: untitled
# version: 1

111111111111111111111111111111111111111111111111111111111
100000000100001111101000000000000000000000000000000000021
100000000100000000001000000000000000000000000000000000021
131000000111001111101111000001000000000000000000000000021
130000000000000001100000000000000000011000000000000000021
131000000111001111101111000000001000000000000000000000021
100000000100000000001000000000000000000000000000000000021
100000000100000000001000000000000001000000000000000000021
131000000111001111101111000001000000000000000000000000021
131000000000000001100000000000001000000000010000000000021
131000000111001111101111000000001000001000000000000000021
100000000100000000001000000000000000001000000000000000021
100000000100000000001000000000100100100000000000000000021
131100000111001111101111000000000110001000000000000000021
131100000000000001100000000010010000000000000000000000021
131100000111001111101111000010010000000000000000000000021
100000000100000000001000000000000000010000100000000000021
100000000100000000001000000000000110000100000000000000021
131110000111001111101111000000000000000000000000000000021
130000000000000001100000000000100000010010000000000000021
131110000111001111101111000000000000000000000000000000021
100000000100000000001000000000000000000000000000000000021
100000000100001111101000000000000000000000000000000000021
111111111111111111111111111111111111111111111111111111111
