# name: untitled
# version: 1

111111111111111111111111111111
101000001000100000100000000011
101110101010101110101111101111
100010101010101010000000100011
111010111010101011111111111011
100010000010100010000000100011
101110111110101110111110101011
101000100010201000100000001011
101011101011111011111111111011
101010001000001010000000001011
101011101011111010111111101111
101000101000001000100000100011
101110101111101111111010111011
100010100010001000000010101011
111010111110101011111110101011
101010001000100010100000001011
101011101011111110101111111011
101000100010001000101000001011
101110111111101012101011101011
101002101000001010101000101011
101011101010111010101110101011
101000100010000010001000100011
101110111110111111111011111011
100000100010100000000010100011
101111101011101111111110101111
100010001010001000100010001011
111010111010111011101010111011
100000100000100000001000000011
111111111111111111111111111111
