# name: untitled
# version: 1

111111111111111111111111111111
101000001000000000100000100011
101110101011111110101110111011
100000121000001010100012000011
111111101111101010111011111011
100000100010001010000010001011
101011111010111011111110111011
101010001010101000000010000011
101010101010101011101110111111
101000101000101010100010001011
101111101111101010111011101011
101000001000100000100000100011
101011101010101111101110111011
101010100010100010001000100011
101010111110111110111011101111
101010000000000010101010101011
101011111111111010101010101011
101000000010000010100000100011
101111111010111110101111111011
101000001010000000101000001011
101011101011111111111011101011
101010001000000010001010100011
101110111111111010101010111111
100010000000001000100010000011
111011111011101111111111101011
101000001010100000001000001011
101111101010111111101011111011
100000000010000000000010000011
111111111111111111111111111111
