# name: sample_basic
# version: 1

1111111111
1000000001
1030200001
1000110001
1000003001
1111111111