# best_food_time_achieved_at: 2026-04-19 14:53
# best_food_time_seconds: 3.8
# best_food_time_ticks: 57
# name: walled
# version: 1

111111111111111
100000000000001
100000000000001
100000001110001
100000000000001
100000001010001
100000001010001
100111001010001
100000001210001
100121001210001
100111001110001
100000000000001
100000000000001
111111111111111
